R 800 600
NO ./textures/brick.xpm
WE ./textures/eagle.xpm
EA ./textures/green.xpm
SO ./textures/ban.xpm
S ./textures/star.xpm
F 94,29,29
C 36,26,26
        1111111111111111111111111
        1000000000110000000000001
        1011000001110000001000001
        1001000000000000000000001
111111111011000001110000000000001
100000000011000001110111112111111
11110111111111011100000010001
11110111111111011101010012021
11000000110101011100000010001
10000000000000001100000010001
10000000000000001101010010N01
110000011101010111111111100011
11101111 1111101 1011110100011
11111111 1111111 111111111111